size:10
rows:65
cols:65
---------------------------XX------------------------------------
---------------------------X-X-----------------------------------
-----------------------------X----XX-----------------------------
-------------------------XXXX-XX--X--X---------------------------
-------------------------X--X---X-X-XX---------------------------
----------------------------X-X-X-X------------------------------
-----------------------------XX-X-X------------------------------
---------------------------------X-------------------------------
-----------------------------------------------------------------
-------------------XX--------------------------------------------
--------------------X--------X-----------------------------------
--------------------X-X-----XX-----------------------------------
---------------------XX------------------------------------------
-----------------------------------X-----------------------------
------------------------------------X----------------------------
----------------------------------XXX----------------------------
-----------------------------------------------------------------
-------------------------X---------------------------------------
-------------------------XX--------------------------------------
------------------------X-X----XX----------------------X---------
-------------------------------X---------------------XXX---------
--------------------------------XXX-----------------X------------
----------------------------------X-----------------XX-----------
-----------------------------------------------------------------
---------------------------------------------X-------------------
----------------------------------------------XX------------XX---
---------------------------------------------XX--------------X---
---XX--------------------------------------------------------X-XX
----X---------XX-------------------------------------X-----XXX--X
--X----------X-X-------------------------------------XX---X---XX-
--XXXXX--------X-----XX-----------------------------------XX-X---
-------X-------------X----------------------XX---------------X---
----XXX------------X-X---------------------X-X------------XXX----
---X---------------XX----------------------X-------------X-------
---X-XX-----------------------------------XX-----X--------XXXXX--
-XX---X---XX-------------------------------------X-X----------X--
X--XXX-----X-------------------------------------XX---------X----
XX-X--------------------------------------------------------XX---
---X--------------XX---------------------------------------------
---XX------------XX----------------------------------------------
-------------------X---------------------------------------------
-----------------------------------------------------------------
-----------XX-----------------X----------------------------------
------------X-----------------XXX--------------------------------
---------XXX---------------------X-------------------------------
---------X----------------------XX----X-X------------------------
--------------------------------------XX-------------------------
---------------------------------------X-------------------------
-----------------------------------------------------------------
----------------------------XXX----------------------------------
----------------------------X------------------------------------
-----------------------------X-----------------------------------
------------------------------------------XX---------------------
-----------------------------------XX-----X-X--------------------
-----------------------------------X--------X--------------------
--------------------------------------------XX-------------------
-----------------------------------------------------------------
-------------------------------X---------------------------------
------------------------------X-X-XX-----------------------------
------------------------------X-X-X-X----------------------------
---------------------------XX-X-X---X--X-------------------------
---------------------------X--X--XX-XXXX-------------------------
-----------------------------XX----X-----------------------------
-----------------------------------X-X---------------------------
------------------------------------XX---------------------------